s s s s s 0 0 0 0 0 0 0 0 0 0 0 s s 0 s s 0 0 0 0 0 0 0 0 s 0 0 0 0 0 0 s 0 0 0 0 0 0 0 0 0 0 0 0 0 0 0 0 0 0 0 s 0 0 s s s s 0
0 0 0 0 s 0 0 0 0 0 0 0 0 0 0 0 0 0 0 s s 0 0 0 0 0 0 0 0 s 0 0 0 0 0 0 s 0 0 0 0 0 0 0 0 0 0 0 0 0 0 0 0 0 0 0 s 0 0 s s s s 0
0 0 0 0 s 0 0 0 0 1 3 0 0 0 0 0 0 0 0 s s 0 0 1 2 3 0 0 0 s 0 0 0 0 0 0 s 0 0 0 0 0 0 0 0 0 0 0 0 0 0 0 0 0 0 0 s 0 0 s s s s 0
0 0 0 0 s 0 0 0 0 7 9 0 0 0 s 0 0 0 0 s s 0 0 4 5 5 2 3 0 s 0 0 0 0 0 0 s 0 0 0 0 0 0 0 0 0 0 0 0 0 0 0 0 0 0 0 s 0 0 s s s s 0
0 0 0 0 s 0 0 0 0 s s s s s s 0 0 0 0 s s 0 0 7 8 8 8 9 0 s 0 0 0 0 0 0 s 0 0 0 0 0 0 0 0 0 0 0 0 0 0 0 0 0 0 0 s 0 0 s s s s 0
0 0 0 0 0 0 0 0 0 0 0 s 0 0 0 0 0 0 0 0 0 0 0 0 0 0 0 0 0 0 0 0 0 0 0 0 s 0 0 0 0 0 0 0 0 0 0 0 0 0 0 0 0 0 0 0 s 0 0 s s s s 0
0 0 0 0 s s s s s s 0 s 0 0 0 0 0 0 0 0 0 0 0 0 0 0 0 0 0 0 0 0 0 0 0 0 s 0 0 0 0 0 0 0 0 0 0 0 0 0 0 0 0 0 0 0 s 0 0 s s s s 0
0 0 0 0 0 0 0 0 0 s 0 0 0 0 0 0 0 0 0 s s 0 0 0 0 0 0 0 0 0 0 0 0 0 0 0 0 0 0 0 0 0 0 0 0 0 0 0 0 0 0 0 0 0 0 0 s 0 0 s s s s 0
s 0 0 0 s s s s 0 s 0 0 0 0 0 0 1 2 0 0 0 0 0 0 0 0 0 0 0 0 0 0 0 0 0 0 0 0 0 0 0 0 0 0 0 0 0 0 0 0 0 0 0 0 0 0 s 0 0 s s s s 0
s 0 0 0 0 0 0 s 0 s 0 s s s s 0 4 6 0 0 0 0 0 0 0 0 0 0 0 0 0 0 0 0 0 0 0 0 0 0 0 0 0 0 0 0 0 0 0 0 0 0 0 0 0 0 s 0 0 s s s s 0
s s s s s 0 0 s 0 s 0 s s s 1 2 5 6 0 0 0 0 0 0 0 0 0 0 0 s 0 0 0 0 0 0 0 0 0 0 0 0 0 0 0 0 0 0 0 0 0 0 0 0 0 0 s 0 0 s s s s 0
0 0 0 0 0 0 0 s 0 s 0 0 s s 7 8 8 9 0 0 0 0 0 0 0 0 0 0 0 s 0 0 0 0 0 0 0 0 0 0 0 0 0 0 0 0 0 0 0 0 0 0 0 0 0 0 s 0 0 s s s s 0
0 0 0 0 s 0 0 s 0 s 0 0 0 s s 0 0 0 0 0 0 0 s s s s 0 0 0 s 0 0 0 0 0 0 0 0 0 0 0 0 0 0 0 0 0 0 0 0 0 0 0 0 0 0 s 0 0 s s s s 0
0 0 0 0 s 0 0 s 0 s 0 0 0 0 0 0 0 0 0 0 0 0 0 0 0 0 0 0 0 s 0 0 0 0 0 0 0 0 0 0 0 0 0 0 0 0 s 0 0 0 0 0 0 0 0 0 s 0 0 s s s s 0
0 0 0 0 s 0 0 s 0 s 0 0 0 0 0 0 0 0 0 0 0 0 0 0 0 0 0 0 0 s 0 0 0 0 0 0 0 0 0 0 0 0 0 0 0 0 s 0 0 0 0 0 0 0 0 0 s 0 0 s s s s 0
0 0 0 0 0 0 0 0 0 s 0 0 0 0 0 0 0 0 0 s 0 0 0 0 0 0 0 0 0 s 0 0 0 0 0 0 0 0 0 0 0 0 0 0 0 0 s 0 0 0 0 0 0 0 0 0 s 0 0 s s s s 0
0 0 0 0 0 0 0 0 0 s 0 0 0 0 0 0 0 0 0 s 0 0 0 0 0 0 0 0 0 s 0 0 0 0 0 0 0 0 0 0 0 0 0 0 0 0 s 0 0 0 0 0 0 0 0 0 s 0 0 s s s s 0
0 0 0 0 0 0 0 0 0 s 0 0 0 0 0 0 0 0 0 s 0 0 0 0 0 0 0 0 0 s 0 0 0 0 0 0 0 0 0 0 0 0 0 0 0 0 s 0 0 0 0 0 0 0 0 0 s 0 0 s s s s 0
0 0 0 0 0 0 0 0 0 s 0 0 0 0 0 0 0 0 0 s s 0 0 0 0 0 0 0 s s 0 0 0 0 0 0 0 0 0 0 0 0 0 0 s s s s s 0 0 0 0 0 0 0 s 0 0 s s s s 0
0 0 0 0 0 0 0 0 0 s 0 0 0 0 0 0 0 0 0 s s 0 0 0 0 0 0 s s s 0 0 0 0 0 0 0 0 0 0 0 0 0 0 0 s s s 0 0 0 0 0 0 0 0 s 0 0 s s s s 0
0 0 0 0 0 0 0 0 0 s 0 0 0 0 0 0 0 0 0 s s 0 0 0 0 0 s 0 0 0 0 0 0 0 0 0 s 0 0 0 0 0 0 0 0 0 s 0 0 0 0 0 0 0 0 0 s 0 0 s s s s 0
0 0 0 0 0 0 0 0 0 s 0 0 0 0 0 0 0 0 0 s s 0 0 0 0 s 0 0 0 0 0 0 0 0 0 0 s 0 0 0 0 0 0 0 0 0 0 0 0 0 0 0 0 0 0 0 s 0 0 s s s s 0
0 0 0 0 0 0 0 0 0 s 0 0 0 0 0 0 0 0 s s s 0 0 0 s 0 0 0 0 s s s 0 0 0 0 s 0 0 0 0 0 B R A D L E Y 0 0 0 0 0 0 0 s 0 0 s s s s 0
0 0 0 0 0 0 0 0 0 s 0 0 0 0 0 0 0 s 0 0 0 0 0 s 0 0 0 0 s s 0 0 s 0 0 0 s 0 0 0 0 0 0 0 0 0 0 0 0 0 0 0 0 0 0 0 s 0 0 s s s s 0
0 0 0 0 0 0 0 0 0 s 0 0 0 0 0 0 s 0 0 0 0 0 s 0 0 0 0 0 s s s 0 0 s 0 0 s 0 0 0 0 0 0 0 0 0 R U L E S 0 0 0 0 0 s 0 0 s s s s 0
0 0 0 0 0 0 0 0 0 s 0 0 0 0 0 s 0 0 0 s s s 0 0 0 0 0 s 0 0 0 s 0 0 0 0 s 0 0 0 0 0 0 0 0 0 0 0 0 0 0 0 0 0 0 0 s 0 0 s s s s 0
0 0 0 0 0 0 0 0 0 s 0 0 0 0 s 0 0 0 0 s s s s 0 0 0 s 0 0 0 0 0 s 0 0 0 s 0 0 0 0 0 0 0 0 0 s 0 0 0 0 0 0 0 0 0 s 0 0 s s s s 0
0 0 0 0 0 0 0 0 0 s 0 0 0 s 0 0 0 0 s s s s s 0 0 0 0 0 0 0 0 0 s 0 0 0 s 0 0 0 0 0 0 0 0 s s s 0 0 0 0 0 0 0 0 s 0 0 s s s s 0
0 0 0 0 0 0 0 0 0 s 0 0 0 s 0 0 0 0 s s s s s 0 0 0 0 0 0 0 0 0 s 0 0 0 s 0 0 0 0 0 0 0 s s s s s 0 0 0 0 0 0 0 s 0 0 s s s s 0
0 0 0 0 0 0 0 0 0 s 0 0 s 0 0 0 0 0 0 s s s s s s s s 0 0 0 0 0 s 0 0 0 s 0 0 0 0 0 0 0 0 0 s 0 0 0 0 0 0 0 0 0 s 0 0 s s s s 0
0 0 0 0 0 0 0 0 0 s 0 0 s 0 0 0 0 0 0 s s s 0 0 0 0 0 s 0 0 0 s 0 0 0 0 s 0 0 0 0 0 0 0 0 0 s 0 0 0 0 0 0 0 0 0 s 0 0 s s s s 0
0 0 0 0 0 0 0 0 0 s 0 0 s 0 0 0 0 0 0 0 0 0 s 0 0 0 0 0 s s s 0 0 s 0 0 s 0 0 0 0 0 0 0 0 0 s 0 0 0 0 0 0 0 0 0 s 0 0 s s s s 0
0 0 0 0 0 0 0 0 0 s 0 0 s 0 0 s s 0 0 0 0 0 0 s 0 0 0 0 s s 0 0 s 0 0 0 s 0 0 0 0 0 0 0 0 0 s 0 0 0 0 0 0 0 0 0 s 0 0 s s s s 0
0 0 0 0 0 0 0 0 0 s 0 0 s 0 0 0 0 s s 0 0 0 0 0 0 0 0 0 0 s s s 0 0 0 0 s 0 0 0 0 0 0 0 0 0 s 0 0 0 0 0 0 0 0 0 s 0 0 s s s s 0
0 0 0 0 0 0 0 0 0 s 0 0 s 0 0 0 0 0 0 s s s 0 0 0 0 0 0 0 0 0 0 0 0 0 0 s 0 0 0 0 0 0 0 0 0 0 0 0 0 0 0 0 0 0 0 s 0 0 s s s s 0
0 0 0 0 0 0 0 0 0 s 0 0 0 s 0 0 0 0 0 s s 0 s 0 0 0 0 0 0 0 0 0 0 0 0 0 s 0 0 0 0 0 0 0 0 0 0 0 0 0 0 0 0 0 0 0 s 0 0 s s s s 0
0 0 0 0 0 0 0 0 0 s 0 0 0 0 s s s 0 0 s s 0 0 s 0 0 0 0 0 s 0 0 0 0 0 s s 0 0 0 0 0 0 0 0 0 0 0 0 0 0 0 0 0 0 0 s 0 0 s s s s 0
0 0 0 0 0 0 0 0 0 s 0 0 0 0 0 0 0 0 0 s s 0 0 0 s 0 0 0 0 s 0 0 0 0 s 0 s 0 0 0 0 0 0 0 0 0 0 0 0 0 0 0 0 0 0 0 s 0 0 s s s s 0
0 0 0 0 0 0 0 0 0 s 0 0 0 0 0 0 0 0 0 s s 0 0 0 0 s s s s s s s s s 0 0 s 0 0 0 0 0 0 0 0 0 0 0 0 0 0 0 0 0 0 0 s 0 0 s s s s 0
0 0 0 0 0 0 0 0 0 s 0 0 0 0 0 0 0 0 0 s s 0 0 0 0 0 0 0 0 s 0 0 0 0 0 0 s 0 0 0 0 0 0 0 0 0 0 0 0 0 0 0 0 0 0 0 s 0 0 s s s s 0
0 0 0 0 0 0 0 0 0 s 0 0 0 0 0 0 0 0 0 s s 0 0 0 0 0 0 0 0 s 0 0 0 0 0 0 s 0 0 0 0 0 0 0 0 0 0 0 0 0 0 0 0 0 0 0 s 0 0 s s s s 0
0 0 0 0 0 0 0 0 0 s 0 0 0 0 0 0 0 0 0 s s 0 0 0 0 0 0 0 0 s 0 0 0 0 0 0 s 0 0 0 0 0 0 0 0 0 0 0 0 0 0 0 0 0 0 0 s 0 0 s s s s 0
0 0 0 0 0 0 0 0 0 s 0 0 0 0 0 0 0 0 0 s s 0 0 0 0 0 0 0 0 s 0 0 0 0 0 0 s 0 0 0 0 0 0 0 0 0 0 0 0 0 0 0 0 0 0 0 s 0 0 s s s s 0
0 0 0 0 0 0 0 0 0 s 0 0 0 0 0 0 0 0 0 s s 0 0 0 0 0 0 0 0 s 0 0 0 0 0 0 s 0 0 0 0 0 0 0 0 0 0 0 0 0 0 0 0 0 0 0 s 0 0 s s s s 0
0 0 0 0 0 0 0 0 0 0 0 0 0 0 0 0 0 0 0 s s 0 0 0 0 0 0 0 0 s 0 0 0 0 0 0 s 0 0 0 0 0 0 0 0 0 0 0 0 0 0 0 0 0 0 0 s 0 0 s s s s 0
0 0 0 0 0 0 0 0 0 0 0 0 0 0 0 0 0 0 0 s s 0 0 0 0 0 0 0 0 s 0 0 0 0 0 0 s 0 0 0 0 0 0 0 0 0 0 0 0 0 0 0 0 0 0 0 s 0 0 s s s s 0
0 0 0 0 0 0 0 0 0 0 0 0 0 0 0 0 0 0 0 s s 0 0 0 0 0 0 0 0 s 0 0 0 0 0 0 s 0 0 0 0 0 0 0 0 0 0 0 0 0 0 0 0 0 0 0 s 0 0 s s s s 0
0 0 0 0 0 0 0 0 0 0 0 0 0 0 0 0 0 0 0 s s 0 0 0 0 0 0 0 0 s 0 0 0 0 0 0 s 0 0 0 0 0 0 0 0 0 0 0 0 0 0 0 0 0 0 0 s 0 0 s s s s 0
0 0 0 0 0 0 0 0 0 0 0 0 0 0 0 0 0 0 0 s s 0 0 0 0 0 0 0 0 s 0 0 0 0 0 0 s 0 0 0 0 0 0 0 0 0 0 0 0 0 0 0 0 0 0 0 s 0 0 s s s s 0
0 0 0 0 0 0 0 0 0 0 0 0 0 0 0 0 0 0 0 s s 0 0 0 0 0 0 0 0 s 0 0 0 0 0 0 s 0 0 0 0 0 0 0 0 0 0 0 0 0 0 0 0 0 0 0 s 0 0 s s s s 0
0 0 0 0 0 0 0 0 0 0 0 0 0 0 0 0 0 0 0 s s 0 0 0 0 0 0 0 0 s 0 0 0 0 0 0 s 0 0 0 0 0 0 0 0 0 0 0 0 0 0 0 0 0 0 0 s 0 0 s s s s 0
0 0 0 0 0 0 0 0 0 0 0 0 0 0 0 0 0 0 0 s s 0 0 0 0 0 0 0 0 s 0 0 0 0 0 0 s 0 0 0 0 0 0 0 0 0 0 0 0 0 0 0 0 0 0 0 s 0 0 s s s s 0
0 0 0 0 0 0 0 0 0 0 0 0 0 0 0 0 0 0 0 s s 0 0 0 0 0 0 0 0 s 0 0 0 0 0 0 s 0 0 0 0 0 0 0 0 0 0 0 0 0 0 0 0 0 0 0 s 0 0 s s s s 0
0 0 0 0 0 0 0 0 0 0 0 0 0 0 0 0 0 0 0 s s 0 0 0 0 0 0 0 0 s 0 0 0 0 0 0 s 0 0 0 0 0 0 0 0 0 0 0 0 0 0 0 0 0 0 0 s 0 0 s s s s 0
0 0 0 0 0 0 0 0 0 s 0 0 0 0 s s 0 0 0 s s 0 0 0 0 0 0 0 0 s 0 0 0 0 0 0 s 0 0 0 0 0 0 0 0 0 0 0 0 0 0 0 0 0 0 0 s 0 0 s s s s 0
0 0 0 0 0 0 0 0 0 s 0 0 0 s s s s 0 0 s s 0 0 0 0 0 0 0 0 s 0 0 0 0 0 0 s 0 0 0 0 0 0 0 0 0 0 0 0 0 0 0 0 0 0 0 s 0 0 s s s s 0
0 0 0 0 0 0 0 0 0 s 0 0 s s s s s s 0 s s 0 0 0 0 0 0 0 0 s 0 0 0 0 0 0 s 0 0 0 0 0 0 0 0 0 0 0 0 0 0 0 0 0 0 0 s 0 0 s s s s 0
0 0 0 0 0 0 0 0 0 s 0 0 0 0 s s 0 0 0 s s 0 0 0 0 0 0 0 0 s 0 0 0 0 0 0 s 0 0 0 0 0 0 0 0 0 0 0 0 0 0 0 0 0 0 0 s 0 0 s s s s 0
0 0 0 0 0 0 0 0 0 s 0 0 0 0 s s 0 0 0 s s 0 0 0 0 0 0 0 0 s 0 0 0 0 0 0 s 0 0 0 0 0 0 0 0 0 0 0 0 0 0 0 0 0 0 0 s 0 0 s s s s 0
0 0 0 0 0 0 0 0 0 s 0 0 0 0 s s 0 0 0 s s 0 0 0 0 0 0 0 0 s 0 0 0 0 0 0 s 0 0 0 0 0 0 0 0 0 0 0 0 0 0 0 0 0 0 0 s 0 0 s s s s 0
0 0 0 0 0 0 0 0 0 s 0 0 0 0 s s 0 0 0 s s 0 0 0 0 0 0 0 0 s 0 0 0 0 0 0 s 0 0 0 0 0 0 0 0 0 0 0 0 0 0 0 0 0 0 0 s 0 0 s s s s 0
0 0 0 0 0 0 0 0 0 s 0 0 0 0 s s 0 0 0 s s 0 0 0 0 0 0 0 0 s 0 0 0 0 0 0 s 0 0 0 0 0 0 0 0 0 0 0 0 0 0 0 0 0 0 0 s 0 0 s s s s 0
0 0 0 0 0 0 0 0 0 s 0 0 0 0 0 0 0 0 0 s s 0 0 0 0 0 0 0 0 s 0 0 0 0 0 0 s 0 0 0 0 0 0 0 0 0 0 0 0 0 0 0 0 0 0 0 s 0 0 s s s s 0
0 0 0 0 0 0 0 0 0 s 0 0 0 0 0 0 0 0 0 s s 0 0 0 0 0 0 0 0 s 0 0 0 0 0 0 s 0 0 0 0 0 0 0 0 0 0 0 0 0 0 0 0 0 0 0 s 0 0 s s s s 0
